24 24 24 24 24 24 24 24 24 24 24 24 24 24 24 24 24 24 24 24 24 24 24 24 24 24 24 24 24 24 24 24 24 24 24 24 24 24 24 24 24 11 11 11 11 11 11 11 11 24 
24 24 24 11 11 24 24 24 24 24 24 24 24 24 24 24 24 24 24 24 24 24 24 24 24 24 24 24 24 24 24 24 24 24 24 24 24 24 24 24 24 24 24 24 24 24 24 11 11 24
24 24 24 11 11 11 11 11 11 11 24 24 11 11 11 11 11 11 11 11 11 11 11 11 11 11 11 11 11 11 11 11 11 11 11 24 24 24 24 24 24 24 24 24 24 24 24 11 11 11
11 24 24 24 11 11 11 11 11 11 11 11 11 11 11 11 11 11 11 11 11 11 11 11 11 11 11 11 11 11 11 11 11 11 11 11 11 11 11 11 11 11 11 11 11 11 11 11 11 11
11 11 11 24 11 11 11 11 11 11 11 11 11 11 11 11 11 11 11 11 11 11 11 11 11 11 11 11 11 11 11 11 11 11 11 11 11 11 11 11 11 11 11 11 11 11 11 11 11 11
11 11 11 11 11 11 11 11 11 11 11 11 11 11 11 11 11 11 11 11 11 11 11 11 11 11 11 11 11 11 11 11 11 11 11 11 11 11 11 11 11 11 11 11 11 11 11 11 11 11
11 11 11 11 11 11 11 11 11 11 11 11 11 11 11 11 11 11 11 11 11 11 11 11 11 11 11 11 11 11 11 11 11 11 11 11 11 11 11 11 11 11 11 11 11 11 11 11 11 11
11 11 11 11 11 11 11 11 11 15 15 15 15 15 15 15 15 15 15 15 15 15 15 15 15 15 15 15 15 15 15 15 15 15 15 15 15 15 15 15 15 11 11 11 11 11 11 11 11 11
11 11 11 11 11 11 11 11 11 17 23 23 23 23 23 23 23 23 35 10 12 10 10 10 10 10 10 23 12 23 23 20 10 10 10 10 10 10 10 10 10 10 16 11 11 11 11 11 11 11
11 11 11 11 11 11 11 11 11 17 23 23 23 23 23 23 23 23 35 10 10 10 12 10 10 10 10 23 23 23 12 23 23 23 23 35 10 10 10 10 10 10 16 11 11 11 11 11 11 11
11 11 11 11 11 11 11 11 11 17 23 10 10 36 23 23 23 23 35 10 10 10 10 10 10 10 10 23 23 23 23 23 23 23 23 35 10 10 10 10 10 10 16 11 11 11 11 11 11 11
11 11 11 11 11 11 11 11 11 17 10 10 10 10 23 23 23 23 35 10 10 10 10 10 10 10 23 23 23 23 39 23 23 23 35 10 10 10 10 10 10 10 16 11 11 11 11 11 11 11
11 11 11 11 11 11 11 11 11 17 10 10 10 10 23 23 23 35 10 10 10 10 10 10 10 10 23 39 23 40 12 23 39 23 35 10 10 10 10 10 10 10 16 11 11 11 11 11 11 11
11 11 11 11 11 11 11 11 11 17 10 10 10 10 23 23 23 23 35 10 10 10 10 10 10 10 23 23 23 23 23 23 23 23 35 10 10 10 10 10 10 10 16 11 11 11 11 11 11 11
11 11 11 11 11 11 11 11 11 17 10 10 10 10 10 36 23 23 23 23 10 10 10 10 23 23 23 23 23 23 23 40 35 10 10 10 10 10 10 10 10 10 16 11 11 11 11 11 11 11
24 24 24 24 24 11 11 11 11 17 10 10 10 10 10 10 23 23 23 23 35 10 10 10 23 23 23 23 23 23 23 23 35 10 10 10 10 10 10 10 10 16 11 11 11 11 11 11 11 24
24 24 24 24 11 11 11 11 11 17 10 10 10 10 10 10 10 23 23 23 23 12 10 10 23 23 40 40 23 39 23 23 35 10 10 10 10 10 10 10 10 16 11 11 11 11 11 11 24 24
24 24 24 24 11 11 11 11 11 17 10 10 10 10 10 36 23 23 23 23 23 35 10 10 23 23 23 23 23 23 23 23 35 10 10 10 10 10 10 10 10 10 16 11 11 11 11 11 11 11
11 11 11 11 11 11 11 11 11 17 10 10 10 10 10 36 23 23 23 39 12 12 12 12 12 23 23 23 35 12 10 10 10 10 10 10 10 10 10 10 10 10 16 11 11 11 11 11 11 11
11 11 11 11 11 11 11 11 11 17 10 10 10 23 23 23 23 23 23 12 12 12 12 12 12 23 40 23 23 12 12 10 10 10 10 10 10 10 10 10 10 10 16 11 11 11 11 11 11 11
11 24 11 11 11 11 11 11 11 17 10 10 10 10 10 10 10 23 23 40 23 12 12 12 12 23 23 23 23 35 10 10 10 10 10 10 10 10 10 10 10 10 16 11 11 11 11 11 11 11
11 11 11 11 11 11 11 11 11 17 10 10 10 10 10 10 10 23 23 23 12 35 12 12 12 37 37 37 37 10 10 10 10 10 10 10 10 10 10 10 10 10 16 11 11 11 11 11 11 24
24 11 11 11 11 11 11 11 11 17 10 10 10 10 10 10 10 23 23 23 23 35 10 12 10 10 10 10 10 10 10 10 10 10 10 10 10 10 10 10 10 10 16 11 11 11 11 11 11 24
24 11 11 11 11 11 11 11 11 17 10 10 10 10 10 10 10 23 23 23 23 35 12 10 10 10 19 18 18 18 18 18 18 18 18 19 10 10 10 10 10 10 16 11 11 11 11 11 11 24
11 24 11 11 11 11 11 11 11 17 10 10 10 10 10 10 10 10 36 23 23 23 23 35 10 10 18 26 26 26 26 26 26 26 26 18 10 23 10 10 10 16 11 11 11 11 11 11 11 24 
24 24 24 24 11 11 11 11 11 17 10 10 10 10 10 10 10 10 10 23 12 23 23 35 10 10 18 26 26 26 26 26 26 26 26 18 10 10 10 10 16 11 11 11 11 11 11 11 24 24
24 24 24 24 24 24 24 11 11 17 10 10 10 10 10 10 10 10 10 37 37 37 37 10 10 10 18 26 26 26 26 26 26 26 26 18 10 10 10 10 16 11 11 11 11 11 11 24 24 24
24 24 24 24 24 11 11 11 11 17 10 10 10 10 10 10 10 10 10 10 10 10 10 10 10 10 18 26 26 26 26 26 26 26 26 18 10 10 10 10 10 16 11 11 11 11 11 24 24 24
24 24 24 11 11 24 24 24 24 17 10 10 10 10 10 10 10 10 10 10 10 10 10 10 13 10 18 26 26 26 26 26 26 26 26 18 10 10 10 10 10 16 11 11 11 11 11 24 24 24
24 24 24 11 11 11 11 11 11 17 10 10 10 10 10 10 10 10 10 10 23 23 23 23 35 10 20 18 26 18 18 18 18 18 18 20 10 10 10 16 11 11 11 11 11 11 11 24 24 24
24 24 11 11 11 11 11 11 11 17 10 10 10 10 10 10 10 10 10 10 23 23 39 23 35 10 10 10 10 12 10 10 10 10 10 10 10 10 10 10 10 10 16 11 11 11 11 24 24 24
24 24 24 24 11 11 11 11 11 17 10 10 10 10 10 10 10 10 10 10 23 23 23 23 35 10 10 10 10 12 10 10 10 10 10 10 10 10 10 10 10 10 16 11 11 11 24 24 24 24
24 24 24 24 24 11 11 11 11 11 17 10 10 10 10 10 10 10 10 10 10 23 23 23 23 35 10 10 10 10 12 10 10 10 10 10 10 10 10 10 10 10 16 16 11 11 11 11 24 24
24 24 24 24 24 11 11 11 11 17 10 10 10 10 10 10 10 10 10 10 10 36 23 23 23 23 23 23 23 35 10 10 10 10 10 10 10 10 10 10 10 10 10 16 11 11 11 11 11 24
24 24 24 24 24 11 11 11 11 17 10 10 10 10 10 10 10 10 10 10 10 36 39 23 23 23 23 23 23 35 10 10 10 10 10 10 10 10 10 10 10 10 10 16 11 11 11 11 11 24
24 24 24 24 24 11 11 11 17 10 10 10 10 10 10 10 10 10 10 10 36 23 23 23 39 35 10 10 10 10 10 10 10 10 10 10 10 10 10 10 10 10 10 16 11 11 11 11 24 24
24 24 24 24 24 11 11 11 17 10 10 10 10 10 10 10 10 10 10 10 36 23 23 23 23 35 10 10 10 10 10 10 10 10 10 10 10 10 10 10 10 10 10 16 11 11 11 11 24 24
24 24 24 24 24 11 11 11 17 10 10 10 10 10 10 10 10 10 10 10 10 10 36 23 23 23 23 35 10 10 10 10 10 10 10 10 10 10 18 10 10 10 14 16 11 11 11 11 24 24
11 11 11 11 11 11 11 11 17 10 10 10 10 10 10 10 10 10 10 10 10 10 36 23 23 23 23 35 10 10 10 10 10 10 10 10 28 18 27 18 10 16 11 11 11 11 11 11 24 24
11 11 11 11 11 11 11 11 17 10 10 10 10 10 10 10 10 10 10 10 10 10 10 10 10 10 10 10 10 10 10 10 10 10 10 10 10 29 28 28 29 16 11 11 11 11 11 24 24 24
11 11 11 11 11 11 11 11 17 10 10 10 10 10 10 10 10 10 10 10 10 10 10 10 10 10 10 10 10 10 10 10 10 10 10 10 29 28 28 10 10 10 16 11 11 11 11 24 24 24
11 11 11 11 11 11 11 11 17 10 10 10 10 10 10 10 10 10 10 10 10 10 10 10 10 10 10 10 10 10 10 10 10 10 10 10 29 28 28 10 10 10 16 11 11 11 11 24 24 24
11 11 11 11 11 11 11 11 11 14 14 14 14 14 14 14 14 14 14 14 14 14 14 14 14 14 14 14 14 14 14 14 14 14 14 14 14 14 14 10 10 10 16 11 11 11 11 24 24 24
11 11 11 11 11 11 11 11 11 11 11 11 11 11 11 11 11 11 11 11 11 11 11 11 11 11 11 11 11 11 11 11 11 11 11 11 11 11 11 10 10 16 11 11 11 11 24 24 24 24
11 11 11 11 11 11 11 11 11 11 11 11 11 11 11 11 11 11 11 11 11 11 11 11 11 11 11 11 11 11 11 11 11 11 11 11 11 11 11 14 10 16 11 11 11 24 24 24 24 24
11 11 11 11 11 11 11 11 11 11 11 11 11 11 11 11 11 11 11 11 11 11 11 11 11 11 11 11 11 11 11 11 11 11 11 11 11 11 11 11 14 11 11 11 24 24 24 24 24 24
11 11 11 24 24 11 11 11 11 11 11 11 11 11 11 11 11 11 11 11 11 11 11 11 11 11 11 11 11 11 11 11 11 11 11 11 11 11 11 11 11 11 11 11 24 24 24 24 24 24
11 11 11 24 11 11 11 11 11 11 11 11 11 11 11 11 11 11 11 11 11 11 11 11 11 11 11 11 11 11 11 11 11 11 11 11 11 11 11 11 11 11 11 11 24 24 24 24 24 24
11 24 24 11 24 11 11 11 11 11 11 11 11 11 11 11 11 11 11 11 11 11 11 11 11 11 11 11 11 11 11 11 11 11 11 11 11 11 11 11 11 11 11 11 24 24 24 24 24 24
24 24 24 24 11 11 11 11 11 11 11 11 11 11 11 11 11 11 11 11 11 11 11 11 11 11 11 11 11 11 11 11 11 11 11 11 11 11 11 24 24 24 24 24 24 24 24 24 24 24
